#####
#@$.#
#####
;
#######
#     #
#   $@#
# .   #
# . $ #
#     #
#######
;
#####
#@  #
# #$###
# $ ..#
#######
;
  ###
  #.#
  # ####
###$ $.#
#. $@###
####$#
   #.#
   ###